"filename", "language", "Python", "HTML", "JavaScript", "comment", "blank", "total"
"/Users/tobiastrentzsch/Desktop/Beuth Medieninformatik/Formales/Bachelorarbeit/DORA-Metrik/DORA-Metrics/add_metric.py", "Python", -38, 0, 0, -2, -9, -49
"/Users/tobiastrentzsch/Desktop/Beuth Medieninformatik/Formales/Bachelorarbeit/DORA-Metrik/DORA-Metrics/add_project.py", "Python", -16, 0, 0, 0, -5, -21
"/Users/tobiastrentzsch/Desktop/Beuth Medieninformatik/Formales/Bachelorarbeit/DORA-Metrik/DORA-Metrics/add_user.py", "Python", -16, 0, 0, 0, -5, -21
"/Users/tobiastrentzsch/Desktop/Beuth Medieninformatik/Formales/Bachelorarbeit/DORA-Metrik/DORA-Metrics/delete_db.py", "Python", -30, 0, 0, 0, -7, -37
"/Users/tobiastrentzsch/Desktop/Beuth Medieninformatik/Formales/Bachelorarbeit/DORA-Metrik/DORA-Metrics/main.py", "Python", -40, 0, 0, -4, -9, -53
"/Users/tobiastrentzsch/Desktop/Beuth Medieninformatik/Formales/Bachelorarbeit/DORA-Metrik/DORA-Metrics/oldscripts/add_metric.py", "Python", 38, 0, 0, 2, 9, 49
"/Users/tobiastrentzsch/Desktop/Beuth Medieninformatik/Formales/Bachelorarbeit/DORA-Metrik/DORA-Metrics/oldscripts/add_project.py", "Python", 16, 0, 0, 0, 5, 21
"/Users/tobiastrentzsch/Desktop/Beuth Medieninformatik/Formales/Bachelorarbeit/DORA-Metrik/DORA-Metrics/oldscripts/add_user.py", "Python", 16, 0, 0, 0, 5, 21
"/Users/tobiastrentzsch/Desktop/Beuth Medieninformatik/Formales/Bachelorarbeit/DORA-Metrik/DORA-Metrics/oldscripts/delete_db.py", "Python", 30, 0, 0, 0, 7, 37
"/Users/tobiastrentzsch/Desktop/Beuth Medieninformatik/Formales/Bachelorarbeit/DORA-Metrik/DORA-Metrics/static/js/main.js", "JavaScript", 0, 0, 28, 0, 5, 33
"/Users/tobiastrentzsch/Desktop/Beuth Medieninformatik/Formales/Bachelorarbeit/DORA-Metrik/DORA-Metrics/templates/index.html", "HTML", 0, 3, 0, -1, 1, 3
"/Users/tobiastrentzsch/Desktop/Beuth Medieninformatik/Formales/Bachelorarbeit/DORA-Metrik/DORA-Metrics/views/auth.py", "Python", 39, 0, 0, 2, 9, 50
"Total", "-", -1, 3, 28, -3, 6, 33