"filename", "language", "Python", "HTML", "Markdown", "JavaScript", "Ini", "comment", "blank", "total"
"/Users/tobiastrentzsch/Desktop/Beuth Medieninformatik/Formales/Bachelorarbeit/DORA-Metrik/DORA-Metrics/README.md", "Markdown", 0, 0, 14, 0, 0, 0, 11, 25
"/Users/tobiastrentzsch/Desktop/Beuth Medieninformatik/Formales/Bachelorarbeit/DORA-Metrik/DORA-Metrics/add_user.py", "Python", 16, 0, 0, 0, 0, 0, 5, 21
"/Users/tobiastrentzsch/Desktop/Beuth Medieninformatik/Formales/Bachelorarbeit/DORA-Metrik/DORA-Metrics/db.py", "Python", 2, 0, 0, 0, 0, 0, 2, 4
"/Users/tobiastrentzsch/Desktop/Beuth Medieninformatik/Formales/Bachelorarbeit/DORA-Metrik/DORA-Metrics/delete_db.py", "Python", 24, 0, 0, 0, 0, 0, 6, 30
"/Users/tobiastrentzsch/Desktop/Beuth Medieninformatik/Formales/Bachelorarbeit/DORA-Metrik/DORA-Metrics/main.py", "Python", 66, 0, 0, 0, 0, 3, 27, 96
"/Users/tobiastrentzsch/Desktop/Beuth Medieninformatik/Formales/Bachelorarbeit/DORA-Metrik/DORA-Metrics/migrations/alembic.ini", "Ini", 0, 0, 0, 0, 38, 0, 13, 51
"/Users/tobiastrentzsch/Desktop/Beuth Medieninformatik/Formales/Bachelorarbeit/DORA-Metrik/DORA-Metrics/migrations/env.py", "Python", 54, 0, 0, 0, 0, 34, 26, 114
"/Users/tobiastrentzsch/Desktop/Beuth Medieninformatik/Formales/Bachelorarbeit/DORA-Metrik/DORA-Metrics/migrations/versions/3011b84cd898_.py", "Python", 24, 0, 0, 0, 0, 12, 7, 43
"/Users/tobiastrentzsch/Desktop/Beuth Medieninformatik/Formales/Bachelorarbeit/DORA-Metrik/DORA-Metrics/migrations/versions/3a3b0e80b297_.py", "Python", 14, 0, 0, 0, 0, 12, 9, 35
"/Users/tobiastrentzsch/Desktop/Beuth Medieninformatik/Formales/Bachelorarbeit/DORA-Metrik/DORA-Metrics/migrations/versions/7135d8fabc54_.py", "Python", 16, 0, 0, 0, 0, 12, 7, 35
"/Users/tobiastrentzsch/Desktop/Beuth Medieninformatik/Formales/Bachelorarbeit/DORA-Metrik/DORA-Metrics/migrations/versions/7b8096797296_.py", "Python", 16, 0, 0, 0, 0, 12, 9, 37
"/Users/tobiastrentzsch/Desktop/Beuth Medieninformatik/Formales/Bachelorarbeit/DORA-Metrik/DORA-Metrics/migrations/versions/a5d65c70c185_add_code_change_volume_column.py", "Python", 12, 0, 0, 0, 0, 12, 9, 33
"/Users/tobiastrentzsch/Desktop/Beuth Medieninformatik/Formales/Bachelorarbeit/DORA-Metrik/DORA-Metrics/static/js/main.js", "JavaScript", 0, 0, 0, 100, 0, 1, 22, 123
"/Users/tobiastrentzsch/Desktop/Beuth Medieninformatik/Formales/Bachelorarbeit/DORA-Metrik/DORA-Metrics/templates/index.html", "HTML", 0, 218, 0, 0, 0, 5, 48, 271
"/Users/tobiastrentzsch/Desktop/Beuth Medieninformatik/Formales/Bachelorarbeit/DORA-Metrik/DORA-Metrics/templates/login.html", "HTML", 0, 42, 0, 0, 0, 1, 6, 49
"Total", "-", 244, 260, 14, 100, 38, 104, 207, 967