"filename", "language", "Python", "HTML", "JavaScript", "comment", "blank", "total"
"/Users/tobiastrentzsch/Desktop/Beuth Medieninformatik/Formales/Bachelorarbeit/DORA-Metrik/DORA-Metrics/main.py", "Python", 30, 0, 0, -5, -4, 21
"/Users/tobiastrentzsch/Desktop/Beuth Medieninformatik/Formales/Bachelorarbeit/DORA-Metrik/DORA-Metrics/migrations/env.py", "Python", 12, 0, 0, -17, 5, 0
"/Users/tobiastrentzsch/Desktop/Beuth Medieninformatik/Formales/Bachelorarbeit/DORA-Metrik/DORA-Metrics/migrations/versions/0a21c3da577f_.py", "Python", 5, 0, 0, -7, 2, 0
"/Users/tobiastrentzsch/Desktop/Beuth Medieninformatik/Formales/Bachelorarbeit/DORA-Metrik/DORA-Metrics/migrations/versions/22a4b5ae535a_.py", "Python", 5, 0, 0, -7, 2, 0
"/Users/tobiastrentzsch/Desktop/Beuth Medieninformatik/Formales/Bachelorarbeit/DORA-Metrik/DORA-Metrics/migrations/versions/3011b84cd898_.py", "Python", 5, 0, 0, -7, 2, 0
"/Users/tobiastrentzsch/Desktop/Beuth Medieninformatik/Formales/Bachelorarbeit/DORA-Metrik/DORA-Metrics/migrations/versions/3a3b0e80b297_.py", "Python", 5, 0, 0, -7, 2, 0
"/Users/tobiastrentzsch/Desktop/Beuth Medieninformatik/Formales/Bachelorarbeit/DORA-Metrik/DORA-Metrics/migrations/versions/49810ee574e0_.py", "Python", 5, 0, 0, -7, 2, 0
"/Users/tobiastrentzsch/Desktop/Beuth Medieninformatik/Formales/Bachelorarbeit/DORA-Metrik/DORA-Metrics/migrations/versions/7135d8fabc54_.py", "Python", 5, 0, 0, -7, 2, 0
"/Users/tobiastrentzsch/Desktop/Beuth Medieninformatik/Formales/Bachelorarbeit/DORA-Metrik/DORA-Metrics/migrations/versions/7b8096797296_.py", "Python", 5, 0, 0, -7, 2, 0
"/Users/tobiastrentzsch/Desktop/Beuth Medieninformatik/Formales/Bachelorarbeit/DORA-Metrik/DORA-Metrics/migrations/versions/85305457bfb4_.py", "Python", 5, 0, 0, -7, 2, 0
"/Users/tobiastrentzsch/Desktop/Beuth Medieninformatik/Formales/Bachelorarbeit/DORA-Metrik/DORA-Metrics/migrations/versions/a5d65c70c185_add_code_change_volume_column.py", "Python", 5, 0, 0, -7, 2, 0
"/Users/tobiastrentzsch/Desktop/Beuth Medieninformatik/Formales/Bachelorarbeit/DORA-Metrik/DORA-Metrics/migrations/versions/d31aa6b7a6aa_.py", "Python", 5, 0, 0, -7, 2, 0
"/Users/tobiastrentzsch/Desktop/Beuth Medieninformatik/Formales/Bachelorarbeit/DORA-Metrik/DORA-Metrics/migrations/versions/d60e16d204f8_.py", "Python", 5, 0, 0, -7, 2, 0
"/Users/tobiastrentzsch/Desktop/Beuth Medieninformatik/Formales/Bachelorarbeit/DORA-Metrik/DORA-Metrics/migrations/versions/e3c1ad9ad932_.py", "Python", 17, 0, 0, 5, 11, 33
"/Users/tobiastrentzsch/Desktop/Beuth Medieninformatik/Formales/Bachelorarbeit/DORA-Metrik/DORA-Metrics/migrations/versions/f773ac403d7e_.py", "Python", 5, 0, 0, -7, 2, 0
"/Users/tobiastrentzsch/Desktop/Beuth Medieninformatik/Formales/Bachelorarbeit/DORA-Metrik/DORA-Metrics/models.py", "Python", 1, 0, 0, 0, 0, 1
"/Users/tobiastrentzsch/Desktop/Beuth Medieninformatik/Formales/Bachelorarbeit/DORA-Metrik/DORA-Metrics/static/js/main.js", "JavaScript", 0, 0, 21, -3, 15, 33
"/Users/tobiastrentzsch/Desktop/Beuth Medieninformatik/Formales/Bachelorarbeit/DORA-Metrik/DORA-Metrics/templates/index.html", "HTML", 0, 1, 0, 0, 4, 5
"Total", "-", 120, 1, 21, -104, 55, 93